NO assets/textures/brow.xpm
SO assets/textures/grey_up.xpm
WE assets/textures/grey_v2UP.xpm
EA assets/textures/green.xpm

F 214,245,17
C 13,56,171

111111111111111
10111  11110001111
1000011 1100E00001
110001111111001111
100001111110001
10000000000001
11000000111001
100001111101001
100001000111001
100000111111001
100000000001001
100000111010101
100000100101101
100000111111111
111111111111111
