NO assets/textures/Wall-000.xpm
WE assets/textures/Wall-000.xpm
SO assets/textures/Wall-000.xpm
EA assets/textures/Wall-000.xpm

F 214,245,17
C 13,56,171

111111111111111
101111111000001
100001111000001
110001111111001
  100001111110011
  100000000000011
110000000111001
100001111000001
100001000100001
100000111100001
10000001S100001
100000111100001
100000100100001
100000111100001
111111111111111