NO assets/textures/Wall-000.xpm
WE assets/textures/Wall-000.xpm
SO assets/textures/Wall-000.xpm
EA assets/textures/Wall-000.xpm

F 214,245,17
C 13,56,171

111111111111111
101111111000000001
10000111100000001
11000111111111
111111110001
   10000000011
11100000011100001
100001111101001
100001000111001
100000111111001
100E00000001001
100000111010101
100000100101101
100000111111111
111111111111111