NO assets/textures/Wall-000.xpm
WE assets/textures/Wall-000.xpm
SO assets/textures/Wall-000.xpm
EA assets/textures/Wall-000.xpm

F 214,245,17
C 13,56,171

111111111111111
101111111000001
100001111000001
110001111111001
100001111110001
100000000000011
110000N00111001
100001111101001
100001000111001
100000111111001
100000000001001
100000111010101
100000100101101
100000111111111
111111111111111