NO assets/textures/Wall-000.xpm
WE assets/textures/Wall-000.xpm
SO assets/textures/Wall-000.xpm
EA assets/textures/Wall-000.xpm

F 214,245,17
C 13,56,171

111111111111111
101111111000001
100001111000001
100001111111001
100001111110001
100000000000001
100000000111001
100001111000001
100001000100001
100000100000001
10000000S000001
100000111100001
100000100100001
100000111100001
111111111111111