NO ./assets/textures//Wall-000.xpm
WE ../assets/textures//Wall-000.xpm
SO assets/textures/Wall-000.xpm
EA ./Wall-000.xpm

F 214,245,17
C 13,56,171

111111111111111
100000000000001
100001111000001
100001111111001
100001111110001
1000000N0000001
100000000111001
100000000000001
100000000000001
100000000000001
100000000000001
100000000000001
100000000000001
100000000000001
111111111111111