NO assets/textures/Wall-000.xpm
EA assets/textures/Wall-000.xpm









SO                assets/textures/Wall-000.xpm
WE assets/textures/Wall-000.xpm

C 13,56,        171
F 214,245      ,17


  111111111111111111111111111111111 11111  1111111
1111E000000000000000000000000000001 10001  1000011
11110000000000000000000000000000001 10001  1000011
11111000000000000000000000000000001110001  1000011
    1000000000000000000000000000000000001  10000111111
    1000000000110111000111111110000000001  10000000011
    1000000001010101000100000010000000001  10000111111
11111000000010011101000111100010000000001111000011
10000000000100000001000000100100000000000000000011
10000000000000000101000100000000000000000000000011
10000000000000000101000111111110000000000000000011
10000000000000000000000000000000000000000000000011
11111111111111111111111111111111111111111111111111
