  111111111111111111111111111111111 1111111111111111
111100001E0000000000000000000000000101 10001  1000001
1111000011110000100000000000000000001 10001  1000011
111110000000101110000000000000000000011111011111000011
    100000000100011111111111110000000001  10000111111
    10000000000001            10000000001  10000000011
    10000000000001            10000000001  10000111111
111110000000000001           10000000001111000011
100000000001000001            10000000000000000011
100000000000000001            10000000000000000011
10000000000000000111111111111110000000000000000011
10000000000000000000000000000000000000000000000011
11111111111111111111111111111111111111111111111111
